F 63,63,63
C 0,0,100

NO ./assets/textures/42.xpm
SO ./assets/textures/42.xpm
WE ./assets/textures/42.xpm
EA ./assets/textures/42.xpm


1111111111
1000000001
100000W001
1000000001
1111111111
