SO ./assets/textures/ggori1.xpm
WE ./assets/textures/ggori2.xpm
EA ./assets/textures/ggori3.xpm
NO ./assets/textures/ggori4.xpm
F 0,0,0
C 0,0,0
111111111111111111111111111111111111111111111111
100010100001000010000100101001010010100101000001
1E0000101001010010100101001010010100101001011001
100010001100011000110000000000000000000000011001
111111111111111111111111111111111111111111111001
111111111111111111111111111111111111111111111001
                                            1001
                                            1001
                                            1001
                                            1001
                                            1001
                                            1001
                                            1001
                                            1001
                                            1001
                                            1001
                                            1001
                                            1001 
                                            1001 
                                            1001 
                                            1001 
                                            1001 
                                            1001 
                                            1001 
                                            1001 
                                            1001 
                                            1001 
                                            1001 
                                            1111