NO ./assets/textures/doge.xpm
SO ./assets/textures/42.xpm
WE ./assets/textures/grid.xpm
EA ./assets/textures/00zuck-musk-superJumbo.xpm
F 63,63,63
C 0,0,100

1111111111
1000000001
1N00000001
1000000001
1111111111
