NO ./assets/textures/doge.xpm
SO ./assets/textures/42.xpm
WE ./assets/textures/grid.xpm
EA ./assets/textures/grid.xpm
F 220,100,0
C 225,30,0

111111111111111111111111111111111
1000S0001000000000110000000000001
100000001011000001110000000000001
100000000001000000000000000000001
111111111011000001110000000000001
100000000011000001110111111111111
111101111111110111000000100011111
111101111111110111010100100011111
110000001101010111000000100011111
100000000000000011000000000011111
100000000000000011010100100011111
110000011101010111110111100011111
111101110111010101011110100011111
111111111111111111111111111111111
 