NO ./assets/textures/doge.xpm
SO ./assets/textures/42.xpm
WE ./assets/textures/grid.xpm
EA ./assets/textures/00zuck-musk-superJumbo.xpm
F 0,0,0
C 0,0,0
111111111111111111111111111111111111111111111
100010100101001010010100101001010010100101001
1E0000101001010010100101001010010100101001011
100010001100011000110001100011000110001100011
111111111111111111111111111111111111111111111
111111111111111111111111111111111111111111111