NO ./doge.xpm
SO ./42.xpm
WE ./grid.xpm
EA ./grid.xpm
F 220,100,0
C 225,30,0

11111
10001
1N001
11111