NO ./assets/textures/doge.xpm
SO ./assets/textures/42.xpm
WE ./assets/textures/grid.xpm
EA ./assets/textures/ggori1.xpm
F 63,63,63
C 0,0,100

11111
10001
10001 W
11111
