NO ./assets/textures/doge.xpm
SO ./assets/textures/42.xpm
WE ./assets/textures/grid.xpm
EA ./assets/textures/grid.xpm
F 63,63,63
C 255,0,255

11111
100E1